99999999999999999999999999999999
9999999!!!!!!!!!!!!!!!!!!9999999
999999!333333333333333333!999999
99999!33333333333333333333!99999
99999!33333333333333333333!99999
99999!33333333333333333333!99999
99999!33333333#33333333333!99999
99999!33333333333333333333!99999
99999!33333333333333333333!99999          U
99999!33333333333333333333!99999
99999!33333333333333333333!99999
99999!33333333333333333333!99999
99999!33333333333333333333!99999
99999!33333333333333333333!99999
99999!33333333333333333333!99999              S                             
99999!33333333333333333333!99999
99999!33333333333333333333!99999
99999!333333333333333333333!9999
99999!3333333333333333333333!999
99999!33333333333333333333333!99
999999!3333333333333333333333339
9999999!!!!!!!!!!!!!!!!!!!333339
99999999999999999999999999333339
99999999999999999999999999333339