99999999999999999999999***999999
99999999999999999999999***999999
99999999999999999999999***999999
99999999999999999999999***999999
99999999999999999999999***999999
9999999999999.................99
999999999999..................99                   S
99999999999...................99        
9999999999....................99
999999999...7.................99
99999999........................
999999..........................                            U
99999.....7.....................
999999........................99
99999999......................99              S                
999999999.......7.............99
9999999999....................99
99999999999...................99              U
9999999999999.................99
99999999999999................99                  U          U
999999999999999...............99
9999999999999999..............99
99999999999999999999999999999999
99999999999999999999999999999999