11111111111111111111111111111111
11............................11
1444444444444444$444444444444441
15555555555555555555555555555551
15555555555555555555555555555551
15555555555555555555555555555551
15555555555555555555555555555551
15555555555555555555555555555551
15555555555555555555555555555551
1444444455555!33633!555554444441                               
1......455555!33633!555554.....1
1......455555!33633!555554.....1
1......455555!33633!555554.....1
1......455555!33633!555554.....1
1......455555!33633!555554.....1
1......455555!33633!555554.....1                 U
1......455555!33633!555554.....1
1......455555!33633!555554.....1
1......455555!33633!555554.....1
1......455555!33633!555554.....1
1......455555!33633!555554.....1
1......455555!33633!555554.....1
11.....455555!33633!555554....11
1111111111111!33633!111111111111