22222222222222222222222222222222
22222222222222222222222222222222
2!!!!!!!!!!!!!!^!!!!!!!!!!!!!!!2
2!6363636363636363636363636363!2
2!3636363636363636363636363636!2
2!6363636363636363636363636363!2
2!3636363636363636363636363636!2
2!6363636363636363636363636363!2
22222222222222363632222222222222
2!!!!!!@!!!!!2636362!!!!!@!!!!!2
2!36363@3636!2366632!6363@3636!2
2!63636@6363!2336332!3636@6363!2
2!36363@3636!2366632!6363@3636!2
2!63636@6363!2336332!3636@6363!2
2!36363@3636!2366632!6363@3636!2
2!63636@6363!2336332!3636@6363!2
2!36363@3636!2366632!6363@3636!2
2!63636@6363!2336332!3636@6363!2
2!36363@3636!2366632!6363@3636!2
2!63636@6363!2336332!3636@6363!2
2!36363@3636!2366632!6363@3636!2
2!63636@6363!2336332!3636@6363!2
2!!!!!!@!!!!!2366632!!!!!@!!!!!2
2222222222222*******222222222222