22222222***222222222222222222222
2222222@***@@@@@@@@@@@@@@2222222
222222@@***@@@@@@@@@@@@@@@222222
22222@@@***@@@@@@@@@@@@@@@@22222
222@@@33333333333!33333333@@@222
22@@@333333333333!%33333333@@@22
22@@3333333333333!3333333333@@22
22@33333@33333333!3333333333@@22
22333333333333333!333333@333@@22
22333333333333333!3333333333@@22
66666666666666666633@3333333@@22
6666666666666666663333333333@@22      U
6666666666666666663333333@33@@22
22333333333333333!3333333333@@22
22333333333333@33!3333333333@@22
22@33333333333333!333@333333@@22
22@@3333333333333!3333333333@@22
22@@@333333333333!333333333@@@22
222@@@33333333333!33333333@@@222
22222@@@@@@@@@@@@@@@@@@@@@@22222
222222@@@@@@@@@@@@@@@@@@@@222222
2222222@@@@@@@@@@@@@@@@@@2222222
22222222222222222222222222222222
22222222222222222222222222222222